_ttal|Uma bolsa plástica em chamas.
maralaurato|Técnica en Seguridad, Higiene y Control Ambiental Industrial
reyesluis007|Lic. en Administracion de Negocios Internaciones de la U.V.
Al_xCarlos|Mercadologo en Proceso, Fanático de la Fotografía, Amante de División Minúscula y Boys Like Girls.
escajos|Poblano, chicharronero, cortabolsas y embustero.
MarcoAndresG|En donde gastas tu tiempo, energia y dinero es donde estan tus valores.
MikeFromEngage|Marketing bloke, traveller & Sydney Swan/Arsenal FC fan. Founder of @EngageMrktingAU, @TheBlogDesigner & @plan_lab. Making big small businesses. Say hi!
marchu1967|¡¡¡BIENVENIDOS A TODOS♥..¡¡¡¡¡
AlFernandez75|Engenheiro, Especialista Financeiro, morador do Rio de Janeiro e duplamente Fluminense.
Saudações Tricolores
andreybms|25 anos, Webdesigner, Bacharel em Desenho Industrial - UFCG. Cofundador e Designer Líder da @nuuvem
lucywestenra|Bailarina de ballet frustrada y futura periodista. Beats, couture, idiomas, política, literatura, teatro, vintage y pâtisserie.
ing_ind_83|Ingeniero Industrial d profesion, buen pana y amiguero....
Aldojica|Cuasingeniero, cocinero doméstico, escritor frustrado, político andariego y soñador beligerante.
AndresHuertaCL|Periodista de la UDP | Apasionado por las noticias y la radio, el medio más creíble de Chile. Viva la opinión informada. Amo a @ninna_lunita
jpmauroo|None
Gasoliv|Música, esportes, gastronomia, vinhos e política
Líder de Inteligência Competitiva da Goodyear
fpaisdigital|Es una institución que trabaja por el desarrollo y la masificación de la tecnología en Chile, en las áreas de Educación, Smart Cities y Desarrollo Digital
mrivaden|Ingeniero PUC, Ex Contralor en MP, Ex DF en la UAH, En transición en el grupo UM, Forrest Gump  en lo político, laboral y familiar. Abuelo a la fuerza.
G2VEN|Blades for Industrial use by Personna,  Email glassguardven@gmail.com
de_diego|Diseñador Gráfico (Egresado DuocUc), enamorado de Natalia Marin, aficionado a los autos, redes sociales y noticias en general.
lalo1584|Contador Público... Orgullosamente Ug... estudiando finanzas.... soñador de nacimiento¡¡¡
tato_bonifaz|Ingeniero Industrial, la vida esta llena de tropezones a veces nos caemos o solo simplemente nos duele...pero siempre nos levantamos y seguimos caminando
TimbuNoticias|Página que mostra aos Alvi-Rubros noticias atualizadas sobre o Clube Náutico Capibaribe!!
ALFREDOCOBOS|Contador y de los buenos, consultor de negocios y colaborador de finanzas en TV. Emprendedor crónico. Apasionado y muy comprometido. http://t.co/eu7IjHT2Md
lcrez|F1 addicted. Pitacos sobre automobilismo, política, economia, tecnologias, novidades em geral.
krlosAndresGC|Futuro Ingeniero Industrial
gilvan_sobrinho|Paixão por tecnologia e política.
Nimradir|Ingeniero en telecomunicaciones, fascinado por la tecnología y la literatura, geek de corazón.
abel_flores|Egresado Economía UdeG, orgulloso izquierdiesta-progresista.
Christcan|Profesor de Inglés, cristiano que ama mucho a su familia y además le encanta la tecnología./Teacher of English who loves his family and likes technology.
fredsaikov|Graduado en Comercio Exterior Master en Finanzas
melquisedecmomo|Colombiano, 41 años, casado, tres hijos, medico cirujano, cultivador de bonsais, musicomano, adicto a el motociclismo y a la tecnología.
ColdplayFoster|23. Coldplayer, Fosterer, Muser, Marooner, Tributo. Amo la tecnología y lo retro.
coachricardos|Coach y ciclista urbano.  #Diseñodevida #SaludFinanciera #ModelodeNegocios #BrandingPersonal #Networking #Marketing #Atraccióndeclientes
aalejandrogom|None
joningham|Consultant and analyst in strategic & innovative HR especially HCM & HR 2.0 - creating human & social capital through  HR, OD, enterprise 2.0 and HR technology
Fernanda_1975|Bioquímica. UNSL 99'. San Luis. Casada con German, mascota : Schettino
hercioneto|Marketing, redes sociais, tecnologia, publicidade, notícias, informações, cultura, mídias sociais, web, internet, política, erechim... enfim, um pouco de tudo.
JorgeVanProst|Amante de la buena comida, el gimnasio, el metal, la política pero por sobre todo #BeerLover #Prost
HuitanteCinq|#HC: #bags designed for #fashionistas and built for #influencers.
#HC: #bolsas em edição limitada para #trendsetters.
Anthonyonee|Namorando, Sou Botafoguense, as vezes até chato de mais,  Inspetor de Pintura Industrial N-1, SEQUI/PETROBRAS em fase de Qualificação.( WhatsApp 84 99394493 )
ValdiviaCapital|El Portal de noticias de la Región de Los Ríos. desarrollo@valdiviacapital.cl
panxo_Opazo|Fanático del anime, la tecnología y los deportes, un comunicador frustrado, aveces un solitario incomprendido.
freguem|Bogotano, interesado en tecnología, algo de politica, deportes y en los placeres de la vida! Orgulloso de ser Colombiano e hincha del America de Cali.
felipemsan|Repórter da editoria de esportes no Diário Online (DOL) e interessado em política, cultura e estudos sobre jornalismo e comunicação. Na luta por dias melhores!
AllForRBD|cause we'll always be family. Since: 7/2/2011 ◘ @Tatsazevedo ✌
LISANDROROBERTO|Campo-grandense(apaixonado por essa morena),sãopaulino e gosto de gente.

MS quem ama, defende!

Contato:9136-3663 / 9945-6230
catalinasoto88|Finanzas - Banca de Inversión
arnoldhassan|TSU en Comercio Exterior. Revolucionario, Socialista. Hasta la Victoria siempre Comandante
delrahi|“El vicio inherente al capitalismo es el desigual reparto de bienes. La virtud inherente al socialismo es el equitativo reparto de miseria.” Winston Churchill
Deivicho|Ing. Civil Industrial  ULS
BenjaminMachmar|None
GrecoVane|Abogado U. de Chile, Master en Economía y Gestión, independiente, librepensadora
Pabonhn|Técnico de la Industria Petrolera, Periodista en formacion, Poeta. Narrador Deportivo
Julius_83|Ingeniero Civil Industrial UDP, Rancaguino, Marista y O´Higgiano 100%(radicado Stgo), pasión por el Surf y Básquetbol.
Rochutop|-Las mejores memorias vienes de las malas ideas.☮
nandolamadrid|Director Operativo de la Secretaría de Gobierno
audi21|Aldemar Almeida | #wishlist #updates #clipping #lifestyle #fuckernews #kabbalah #friendship #share #formalebeauty #healthtips
gance|Consultor / Project Manager en Marketing y tecnología - www.privitera.com.ar ///

Escribo en www.gance.com.ar
Guapo como los de antes.
guille18ca10|Pareja con deseos de experimentar cosas nuevas  con ganas de un trio, HMH, en busca de parejas sw para intercambio,compartir y observarnos en fotos
jeovarh_news|Adorador de Jesus, Apaixonado por minha família, Amigo aos que precisarem...
chyepes|Hombre de radio y sus negocios, Colombiano, Creativo, fanático del cine (bueno y malo) y la pizza. Enamorado, leal y justo. Tweets de opiniones personales.
Caro_Argomedo|Egresada de Ingeniería Civil Industrial. Fans del deporte en general, aficionada al Ciclismo y Cruzada desde siempre.
Chupa_CR|DiseñoIndustrial•SportsFan•#Lonchera•#TeamGuapos Juve•Gooner•BVB•PSG•Pats•Thunder•Mets•Nole
ivanerickt|Mercadologo en desarrolló, no molestar :)
VidaPetNews|Vida Pet News é uma revista impressa e on-line para os amantes dos animais domésticos. . https://www.facebook.com/VidaPetNews
vellozors|Carioca apaixonado por viagens, fotografia, gastronomia e um pouco de política pra sair da rotina.
diegofelipegm|International business manager
pablosanchezg|Analista político. Lector empedernido y amante de la música
Noruegoquai|None
BolitadeLobo|Diseñadora Industrial - Artista Visual.
balochini|Nascido no interior do Pará na cidade de Muzambinho, veio para a capital tentar a sorte.
GaboBarrera|Ingeniero Industrial, especialista en produccion y operaciones.
leojackbauer|Regiomontanto interesado en la política, sicología, fisioterapia, running y mas.
schervenski|Partido dos Trabalhadores | Gastronomia | Comunicação | Grêmio | política | ateísmo | Alegrete | Rio Grande do Sul | o Sul como norte, regional por excelência.
DaniaCarolinaG|Estudió  Ing. En administracion de empresas Mención Finanzas en INACAP,
  Trabajo en TELEPIZZA CHILE.
AngelOropezza|Amo la mercadotecnia y los negocios. Love the marketing and business. I´m a professional looking for a new oportunity
Gimicaeela|- Leonchalónica
- Bartender Profesional
- Estudiando Comercio Internacional
- 20 años de juventud 
- Cultura Reggae


- Everything Changes
GTeixeiira|Eletricista Industrial e Atleta de Jiu-Jitsu na academia #GracieHumaita ! Blindado por Deus !
eriturriaga|Toyconpanama100% JuventudPRD,Delegada d J-PRD y IX congreso PRD; 2 sub Secr. Asuntos Electorals. Lic. Finanzas; educadora; asesora de seguros...
Ginonunez|Entusiasta del arte y la ciencia de hacer máquina, del basket, running y ajedrez. Amante de la familia. Ingeniero C. Industrial. De Concepción en Los Ángeles.
rea_fa|Abogado titulado por la UdeG, especialista en el Registro de Marcas  ante el Instituto Mexicano de la Propiedad Industrial.
alcantaraparaty|Paratiense - Música - Teatro - Audio Visual.
andreitaariasr|Madre de Silvana, hija de Dios, hermana de cristo. Amante de la política, los vinos, los chocolates y el sol #Uribista. Asesora de redes sociales #CM
JonyGodoy|Porteño, Ing Comercial, Magíster de Economía y Políticas Públicas de la UAI.
Discípulo de la chorrillana, del fútbol y pensador urbano.
JOAOBFPEREIRA|Amante da boa política, sou acima de tudo lutador, colaborador do enti-público e busco fazer o bem democrático a todos sem distinção por ideal e por amor!.
vanessafilella|Presentadora de @RTUnoticias & @RealidadvivaRTU (19h00) Directora de Radio Costanera 101.7 FM - 91.3 FM
L_u_C_k|estoy harto de todo.. de los hombres, de la política de las redes sociales, de los fanatismos... de todo menos del sexo tía!
luismtzg|Lic. en Comercio Internacional // Regio de nacimiento y rayado de corazón // Runner por convicción.
cristjah|Estdiante de Economía y Finanzas
exnecso|Diseñador Industrial, melómano, honesto, apasionado, creativo, artista, proyectista,  y  futuro Arquitecto. Coordinador en COTA_CERO
Geo_Solutions|Fundada en el 2003 en Panamá. Tiene el propósito de explotar las tecnologías de la información espacial. Digital Globe, Infoterra, Rapid Eye, ERDAS
RGDirCom|Gestión y Dirección de la Comunicación en la nueva #EconomíaDelaReputación. Contribuyo con empresas, lideres y gobiernos en el logro de sus objetivos.
CORROSIONMASTER|Soluciones en Corrosion Industrial, Manejo de Fluidos Corrosivos o Ultra-Puros. Termoplasticos, Recubrimientos y Equipos Anticorrosivos. PPL, PVDF, HDPE, ECTFE
Actuario| Fanático de la tecnología. Científico. Profundamente enamorado de mis #piojitos. Con ganas de dejarles un mundo mejor. Tenista (?). Lector de buena literatura
rsteefen|Industrial & Systems Engineer who loves to work, and looking for success. #RS
TheMarathonist|Amante de la libertad y valores humanos. Apasionada de la fotografia, el diseño y la buena mesa...
japaternina|Ing. Informatico. Especialista En Gerencia Financiera.
danielvalentim1|Estudante de Biologia da UNIFAP. Coordenador Geral do CABIO. Diretor Financeiro da ABIOAP. Estagiário do Laboratório de Zoologia da UNIFAP e DJ
wolfganglc|Fundador de Aumentality.cl, amante de la tecnología, música y películas. Participante de Startup Chile.
